trial,target,delay,time,scrollCount_totalScrollCount,scrollCount_upScrollCount,scrollCount_downScrollCount,scrollCount_reverseScrollCount,participants
1,DIV 5,0,3.956,52,21,31,21,1
2,DIV 1,50,3.108,31,31,0,0,1
3,DIV 1,250,3.238,20,20,0,0,1
4,DIV 7,100,4.537,66,0,66,0,1
5,DIV 2,200,3.081,35,35,0,0,1
6,DIV 5,150,3.937,42,14,28,14,1
7,DIV 5,0,2.48,15,0,15,0,1
8,DIV 1,50,3.378,45,45,0,0,1
9,DIV 5,250,3.14,18,0,18,0,1
10,DIV 3,100,4.325,44,30,14,14,1
11,DIV 1,200,3.288,36,36,0,0,1
12,DIV 5,150,3.65,28,8,20,8,1
13,DIV 3,0,2.511,19,19,0,0,1
14,DIV 6,50,2.827,33,0,33,0,1
15,DIV 3,250,4.657,57,36,21,21,1
16,DIV 3,100,3.815,22,21,1,1,1
17,DIV 5,200,4.002,25,4,21,4,1
18,DIV 2,150,3.715,46,46,0,0,1
19,DIV 2,0,3.531,45,45,0,0,1
20,DIV 6,50,3.004,38,0,38,0,1
21,DIV 5,250,4.753,42,13,29,13,1
22,DIV 3,100,3.18,27,25,2,2,1
23,DIV 3,200,3.878,32,29,3,3,1
24,DIV 3,150,3.389,31,27,4,4,1
25,DIV 7,0,3.422,49,0,49,0,1
26,DIV 3,50,4.088,30,26,4,4,1
27,DIV 7,250,3.37,35,0,35,0,1
28,DIV 2,100,3.84,48,48,0,0,1
29,DIV 5,200,3.533,30,7,23,7,1
30,DIV 5,150,2.705,18,0,18,0,1
31,DIV 1,0,3.273,41,41,0,0,1
32,DIV 5,50,2.861,18,0,18,0,1
33,DIV 3,250,3.821,45,34,11,11,1
34,DIV 7,100,3.244,39,0,39,0,1
35,DIV 7,200,3.444,39,0,39,0,1
36,DIV 6,150,2.926,31,0,31,0,1
37,DIV 2,0,4.129,43,43,0,0,1
38,DIV 1,50,3.771,38,38,0,0,1
39,DIV 5,250,4.785,24,5,19,5,1
40,DIV 5,100,2.946,21,0,21,0,1
41,DIV 7,200,3.027,39,0,39,0,1
42,DIV 3,150,3.216,30,25,5,5,1
43,DIV 6,0,3.189,36,0,36,0,1
44,DIV 7,50,3.34,38,0,38,0,1
45,DIV 1,250,3.464,46,46,0,0,1
46,DIV 5,100,3.501,25,4,21,4,1
47,DIV 1,200,3.178,47,47,0,0,1
48,DIV 2,150,4.294,39,37,2,2,1
49,DIV 7,0,2.988,33,0,33,0,1
50,DIV 6,50,2.756,27,0,27,0,1
51,DIV 6,250,2.977,29,0,29,0,1
52,DIV 5,100,2.945,22,5,17,5,1
53,DIV 2,200,3.284,39,39,0,0,1
54,DIV 2,150,3.014,37,37,0,0,1
55,DIV 6,0,2.856,26,0,26,0,1
56,DIV 3,50,2.756,26,26,0,0,1
57,DIV 1,250,3.468,42,42,0,0,1
58,DIV 1,100,4.028,49,49,0,0,1
59,DIV 7,200,3.741,38,0,38,0,1
60,DIV 3,150,4.067,32,29,3,3,1
61,DIV 6,0,2.979,28,0,28,0,1
62,DIV 7,50,3.239,33,0,33,0,1
63,DIV 7,250,3.646,47,0,47,0,1
64,DIV 6,100,2.815,29,0,29,0,1
65,DIV 6,200,3.055,30,0,30,0,1
66,DIV 7,150,3.484,44,0,44,0,1
67,DIV 2,0,3.422,36,36,0,0,1
68,DIV 7,50,3.076,37,0,37,0,1
69,DIV 3,250,3.809,50,34,16,16,1
70,DIV 7,100,3.051,35,0,35,0,1
71,DIV 1,200,3.298,45,45,0,0,1
72,DIV 7,150,3.373,45,0,45,0,1
73,DIV 7,0,3.226,36,0,36,0,1
74,DIV 5,50,2.397,14,0,14,0,1
75,DIV 7,250,3.339,47,0,47,0,1
76,DIV 1,100,3.51,51,51,0,0,1
77,DIV 5,200,3.658,30,8,22,8,1
78,DIV 7,150,3.183,40,0,40,0,1
79,DIV 5,0,3.047,15,0,15,0,1
80,DIV 5,50,2.739,20,3,17,3,1
81,DIV 2,250,3.034,35,35,0,0,1
82,DIV 2,100,2.95,34,34,0,0,1
83,DIV 6,200,4.864,43,8,35,8,1
84,DIV 1,150,3.516,51,51,0,0,1
85,DIV 1,0,3.7,45,45,0,0,1
86,DIV 3,50,2.789,21,21,0,0,1
87,DIV 2,250,2.73,30,30,0,0,1
88,DIV 6,100,3.028,31,0,31,0,1
89,DIV 6,200,2.854,30,0,30,0,1
90,DIV 6,150,3.061,35,0,35,0,1
91,DIV 1,0,3.058,36,36,0,0,1
92,DIV 2,50,3.186,31,31,0,0,1
93,DIV 2,250,2.873,33,33,0,0,1
94,DIV 1,100,3.273,42,42,0,0,1
95,DIV 2,200,3.311,32,32,0,0,1
96,DIV 6,150,3.477,37,6,31,6,1
97,DIV 3,0,2.932,28,24,4,4,1
98,DIV 2,50,2.591,31,31,0,0,1
99,DIV 6,250,2.742,29,0,29,0,1
100,DIV 6,100,3.222,30,0,30,0,1
101,DIV 3,200,4.117,33,28,5,5,1
102,DIV 1,150,3.331,41,41,0,0,1
103,DIV 3,0,2.818,22,19,3,3,1
104,DIV 2,50,2.876,32,32,0,0,1
105,DIV 6,250,4.632,38,13,25,13,1
106,DIV 2,100,3.237,40,40,0,0,1
107,DIV 3,200,3.518,37,28,9,9,1
108,DIV 1,150,3.299,42,42,0,0,1
1,DIV 6,150,3.525,33,1,32,1,4
2,DIV 1,200,3.836,53,53,0,0,4
3,DIV 3,100,5.007,75,40,35,35,4
4,DIV 6,250,7.75,54,8,46,8,4
5,DIV 2,50,3.965,38,38,0,0,4
6,DIV 1,0,3.713,57,57,0,0,4
7,DIV 1,150,3.587,51,51,0,0,4
8,DIV 3,200,8.033,133,64,69,69,4
9,DIV 2,100,2.817,38,38,0,0,4
10,DIV 6,250,2.98,30,0,30,0,4
11,DIV 6,50,5.862,73,16,57,16,4
12,DIV 6,0,3.137,36,0,36,0,4
13,DIV 5,150,2.706,20,0,20,0,4
14,DIV 7,200,3.862,61,0,61,0,4
15,DIV 3,100,3.172,33,25,8,8,4
16,DIV 5,250,2.84,17,0,17,0,4
17,DIV 2,50,2.829,36,36,0,0,4
18,DIV 1,0,4.421,50,50,0,0,4
19,DIV 2,150,3.522,37,37,0,0,4
20,DIV 1,200,3.801,50,50,0,0,4
21,DIV 5,100,3.294,31,8,23,8,4
22,DIV 6,250,3.448,38,0,38,0,4
23,DIV 7,50,3.373,58,0,58,0,4
24,DIV 5,0,2.713,19,0,19,0,4
25,DIV 5,150,3.632,26,6,20,6,4
26,DIV 6,200,4.487,37,0,37,0,4
27,DIV 6,100,3.592,36,0,36,0,4
28,DIV 5,250,3.024,16,0,16,0,4
29,DIV 5,50,2.874,17,0,17,0,4
30,DIV 5,0,2.26,15,0,15,0,4
31,DIV 5,150,3.432,23,4,19,4,4
32,DIV 5,200,2.801,19,0,19,0,4
33,DIV 5,100,2.966,17,0,17,0,4
34,DIV 7,250,3.894,58,0,58,0,4
35,DIV 6,50,3.492,39,0,39,0,4
36,DIV 1,0,3.559,52,52,0,0,4
37,DIV 6,150,4.445,46,8,38,8,4
38,DIV 1,200,4.077,56,56,0,0,4
39,DIV 5,100,2.495,17,0,17,0,4
40,DIV 7,250,3.605,63,0,63,0,4
41,DIV 6,50,3.71,42,0,42,0,4
42,DIV 3,0,2.935,31,26,5,5,4
43,DIV 6,150,3.838,40,4,36,4,4
44,DIV 5,200,2.679,17,0,17,0,4
45,DIV 2,100,2.704,44,44,0,0,4
46,DIV 5,250,4.378,30,9,21,9,4
47,DIV 3,50,3.436,36,29,7,7,4
48,DIV 3,0,3.084,24,23,1,1,4
49,DIV 7,150,3.718,59,0,59,0,4
50,DIV 6,200,3.423,41,0,41,0,4
51,DIV 1,100,3.715,57,57,0,0,4
52,DIV 1,250,3.854,57,57,0,0,4
53,DIV 7,50,3.712,52,0,52,0,4
54,DIV 5,0,2.927,28,7,21,7,4
55,DIV 2,150,3.769,46,40,6,6,4
56,DIV 3,200,3.711,38,29,9,9,4
57,DIV 7,100,3.987,58,0,58,0,4
58,DIV 3,250,5.764,74,44,30,30,4
59,DIV 2,50,3.586,45,44,1,1,4
60,DIV 2,0,2.794,39,39,0,0,4
61,DIV 1,150,3.725,54,54,0,0,4
62,DIV 2,200,3.103,38,38,0,0,4
63,DIV 2,100,4.351,39,39,0,0,4
64,DIV 2,250,4.628,41,41,0,0,4
65,DIV 1,50,3.825,56,56,0,0,4
66,DIV 6,0,3.287,35,0,35,0,4
67,DIV 7,150,4.103,62,0,62,0,4
68,DIV 3,200,3.987,34,28,6,6,4
69,DIV 7,100,3.535,52,0,52,0,4
70,DIV 3,250,4.256,58,37,21,21,4
71,DIV 7,50,3.512,60,0,60,0,4
72,DIV 2,0,3.589,46,46,0,0,4
73,DIV 7,150,3.62,53,0,53,0,4
74,DIV 5,200,3.871,23,4,19,4,4
75,DIV 1,100,3.609,53,53,0,0,4
76,DIV 3,250,4.874,30,27,3,3,4
77,DIV 3,50,3.15,23,23,0,0,4
78,DIV 3,0,2.771,22,22,0,0,4
79,DIV 2,150,3.76,41,37,4,4,4
80,DIV 7,200,3.81,53,0,53,0,4
81,DIV 7,100,3.386,55,0,55,0,4
82,DIV 2,250,3.242,35,35,0,0,4
83,DIV 3,50,3.254,30,24,6,6,4
84,DIV 7,0,3.088,45,0,45,0,4
85,DIV 3,150,3.555,29,27,2,2,4
86,DIV 7,200,3.552,51,0,51,0,4
87,DIV 1,100,3.576,52,52,0,0,4
88,DIV 7,250,3.704,58,0,58,0,4
89,DIV 1,50,3.73,54,54,0,0,4
90,DIV 6,0,4.233,52,8,44,8,4
91,DIV 3,150,3.583,33,29,4,4,4
92,DIV 6,200,4.038,41,0,41,0,4
93,DIV 6,100,3.979,43,3,40,3,4
94,DIV 1,250,3.814,53,53,0,0,4
95,DIV 1,50,3.988,59,59,0,0,4
96,DIV 7,0,3.529,60,0,60,0,4
97,DIV 1,150,3.788,53,53,0,0,4
98,DIV 2,200,3.331,42,42,0,0,4
99,DIV 6,100,5.97,45,3,42,3,4
100,DIV 2,250,3.646,43,43,0,0,4
101,DIV 5,50,3.149,17,0,17,0,4
102,DIV 7,0,3.304,45,0,45,0,4
103,DIV 3,150,4.176,45,33,12,12,4
104,DIV 2,200,3.475,46,46,0,0,4
105,DIV 3,100,3.655,22,22,0,0,4
106,DIV 1,250,4.108,63,63,0,0,4
107,DIV 5,50,2.469,20,0,20,0,4
108,DIV 2,0,3.684,40,40,0,0,4
1,DIV 2,50,3.328,33,26,7,7,2
2,DIV 1,100,2.483,27,27,0,0,2
3,DIV 3,0,2.154,13,13,0,0,2
4,DIV 1,150,2.46,21,21,0,0,2
5,DIV 3,250,3.58,40,25,15,15,2
6,DIV 2,200,3.238,34,34,0,0,2
7,DIV 2,50,2.287,26,26,0,0,2
8,DIV 6,100,2.969,22,9,13,9,2
9,DIV 5,0,2.143,12,0,12,0,2
10,DIV 3,150,3.187,33,22,11,11,2
11,DIV 6,250,5.629,52,23,29,23,2
12,DIV 3,200,3.25,32,27,5,5,2
13,DIV 5,50,3.474,25,7,18,7,2
14,DIV 7,100,2.77,16,0,16,0,2
15,DIV 6,0,2.87,38,8,30,8,2
16,DIV 5,150,3.516,34,11,23,11,2
17,DIV 7,250,2.409,23,0,23,0,2
18,DIV 5,200,2.937,15,0,15,0,2
19,DIV 1,50,2.884,21,21,0,0,2
20,DIV 5,100,2.917,19,0,19,0,2
21,DIV 2,0,3.815,36,32,4,4,2
22,DIV 3,150,2.427,18,18,0,0,2
23,DIV 2,250,4.012,46,36,10,10,2
24,DIV 1,200,3.142,25,25,0,0,2
25,DIV 5,50,2.992,40,14,26,14,2
26,DIV 7,100,2.987,31,0,31,0,2
27,DIV 5,0,2.63,22,6,16,6,2
28,DIV 1,150,2.79,22,22,0,0,2
29,DIV 2,250,2.385,21,21,0,0,2
30,DIV 7,200,2.484,18,0,18,0,2
31,DIV 1,50,3.165,21,21,0,0,2
32,DIV 3,100,2.835,28,17,11,11,2
33,DIV 3,0,2.723,21,21,0,0,2
34,DIV 5,150,3.611,38,13,25,13,2
35,DIV 3,250,3.561,31,25,6,6,2
36,DIV 3,200,3.355,33,27,6,6,2
37,DIV 2,50,3.112,37,26,11,11,2
38,DIV 2,100,2.867,35,30,5,5,2
39,DIV 5,0,2.24,17,0,17,0,2
40,DIV 7,150,2.942,21,0,21,0,2
41,DIV 5,250,3.826,33,11,22,11,2
42,DIV 6,200,3.61,53,17,36,17,2
43,DIV 3,50,3.069,29,21,8,8,2
44,DIV 7,100,3.351,45,0,45,0,2
45,DIV 3,0,2.798,15,15,0,0,2
46,DIV 3,150,2.598,23,23,0,0,2
47,DIV 1,250,3.585,41,41,0,0,2
48,DIV 2,200,3.769,39,34,5,5,2
49,DIV 6,50,3.32,36,3,33,3,2
50,DIV 3,100,3.122,32,26,6,6,2
51,DIV 7,0,2.962,43,0,43,0,2
52,DIV 5,150,3.425,35,13,22,13,2
53,DIV 5,250,3.349,25,5,20,5,2
54,DIV 5,200,2.173,11,0,11,0,2
55,DIV 1,50,2.961,25,25,0,0,2
56,DIV 2,100,3.065,38,29,9,9,2
57,DIV 1,0,5.267,25,25,0,0,2
58,DIV 7,150,2.758,26,0,26,0,2
59,DIV 5,250,3.51,28,8,20,8,2
60,DIV 7,200,2.802,31,0,31,0,2
61,DIV 3,50,2.387,21,21,0,0,2
62,DIV 3,100,2.251,17,17,0,0,2
63,DIV 6,0,2.909,33,4,29,4,2
64,DIV 7,150,3.045,35,0,35,0,2
65,DIV 1,250,2.83,24,24,0,0,2
66,DIV 5,200,3.317,35,14,21,14,2
67,DIV 5,50,2.568,22,6,16,6,2
68,DIV 1,100,2.592,25,25,0,0,2
69,DIV 7,0,2.599,29,0,29,0,2
70,DIV 2,150,3.191,24,24,0,0,2
71,DIV 2,250,2.56,25,25,0,0,2
72,DIV 7,200,3.568,44,0,44,0,2
73,DIV 7,50,2.585,33,0,33,0,2
74,DIV 1,100,3.333,32,32,0,0,2
75,DIV 1,0,3.897,74,74,0,0,2
76,DIV 1,150,4.112,71,71,0,0,2
77,DIV 1,250,2.942,26,26,0,0,2
78,DIV 1,200,3.269,49,49,0,0,2
79,DIV 3,50,2.785,27,22,5,5,2
80,DIV 5,100,2.98,33,10,23,10,2
81,DIV 2,0,2.741,35,35,0,0,2
82,DIV 6,150,3.375,52,22,30,22,2
83,DIV 3,250,4.023,36,27,9,9,2
84,DIV 6,200,3.609,49,10,39,10,2
85,DIV 6,50,2.974,30,0,30,0,2
86,DIV 5,100,4.724,27,8,19,8,2
87,DIV 7,0,2.763,31,0,31,0,2
88,DIV 6,150,3.017,26,0,26,0,2
89,DIV 6,250,2.48,25,0,25,0,2
90,DIV 1,200,2.874,31,31,0,0,2
91,DIV 7,50,3.151,38,0,38,0,2
92,DIV 2,100,2.778,32,32,0,0,2
93,DIV 2,0,2.904,29,29,0,0,2
94,DIV 6,150,3.119,39,0,39,0,2
95,DIV 6,250,4.458,45,5,40,5,2
96,DIV 3,200,2.748,26,26,0,0,2
97,DIV 6,50,3.129,35,2,33,2,2
98,DIV 6,100,2.887,35,0,35,0,2
99,DIV 6,0,2.648,28,0,28,0,2
100,DIV 2,150,2.594,31,31,0,0,2
101,DIV 7,250,3.322,55,0,55,0,2
102,DIV 6,200,2.963,33,0,33,0,2
103,DIV 7,50,3.04,47,0,47,0,2
104,DIV 6,100,4.822,37,5,32,5,2
105,DIV 1,0,3.18,30,30,0,0,2
106,DIV 2,150,4.817,37,33,4,4,2
107,DIV 7,250,4.149,53,0,53,0,2
108,DIV 2,200,4.229,42,38,4,4,2
1,DIV 3,100,3.065,16,16,0,0,3
2,DIV 7,150,4.149,29,0,29,0,3
3,DIV 7,50,3.245,25,0,25,0,3
4,DIV 6,200,3.033,17,0,17,0,3
5,DIV 7,0,4.256,25,0,25,0,3
6,DIV 3,250,4.891,32,24,8,8,3
7,DIV 3,100,4.639,13,13,0,0,3
8,DIV 7,150,4.218,34,0,34,0,3
9,DIV 6,50,3.53,24,0,24,0,3
10,DIV 1,200,3.849,34,34,0,0,3
11,DIV 6,0,4.157,23,0,23,0,3
12,DIV 6,250,5.607,30,4,26,4,3
13,DIV 3,100,2.77,16,16,0,0,3
14,DIV 3,150,3.491,16,16,0,0,3
15,DIV 1,50,3.526,30,30,0,0,3
16,DIV 7,200,3.99,39,0,39,0,3
17,DIV 3,0,2.655,15,15,0,0,3
18,DIV 5,250,3.104,10,0,10,0,3
19,DIV 2,100,3.285,23,23,0,0,3
20,DIV 7,150,3.886,28,0,28,0,3
21,DIV 1,50,3.565,32,32,0,0,3
22,DIV 7,200,3.495,28,0,28,0,3
23,DIV 5,0,2.201,8,0,8,0,3
24,DIV 6,250,4.51,29,4,25,4,3
25,DIV 7,100,4.324,27,0,27,0,3
26,DIV 3,150,5.274,28,23,5,5,3
27,DIV 6,50,4.191,29,5,24,5,3
28,DIV 6,200,4.369,29,5,24,5,3
29,DIV 3,0,2.539,17,17,0,0,3
30,DIV 7,250,4.271,41,0,41,0,3
31,DIV 1,100,4.355,33,33,0,0,3
32,DIV 3,150,5.888,45,29,16,16,3
33,DIV 1,50,4.369,35,35,0,0,3
34,DIV 3,200,6.26,28,21,7,7,3
35,DIV 1,0,3.19,28,28,0,0,3
36,DIV 2,250,5.489,26,26,0,0,3
37,DIV 1,100,4.502,25,25,0,0,3
38,DIV 2,150,3.514,33,27,6,6,3
39,DIV 5,50,4.489,49,11,38,11,3
40,DIV 5,200,2.204,8,0,8,0,3
41,DIV 6,0,2.285,17,0,17,0,3
42,DIV 7,250,3.331,28,0,28,0,3
43,DIV 1,100,3.904,38,38,0,0,3
44,DIV 5,150,2.28,9,0,9,0,3
45,DIV 5,50,2.149,9,0,9,0,3
46,DIV 5,200,2.117,7,0,7,0,3
47,DIV 5,0,1.908,9,0,9,0,3
48,DIV 3,250,2.913,16,16,0,0,3
49,DIV 2,100,3.232,21,21,0,0,3
50,DIV 6,150,2.967,17,0,17,0,3
51,DIV 5,50,4.674,29,14,15,14,3
52,DIV 3,200,2.657,14,14,0,0,3
53,DIV 3,0,2.849,13,13,0,0,3
54,DIV 2,250,4.818,19,19,0,0,3
55,DIV 5,100,5.372,32,15,17,15,3
56,DIV 2,150,3.623,24,24,0,0,3
57,DIV 3,50,2.694,14,14,0,0,3
58,DIV 6,200,3.135,19,0,19,0,3
59,DIV 5,0,2.482,8,0,8,0,3
60,DIV 1,250,5.161,30,30,0,0,3
61,DIV 7,100,3.432,27,0,27,0,3
62,DIV 1,150,3.698,30,30,0,0,3
63,DIV 2,50,4.745,30,24,6,6,3
64,DIV 7,200,3.429,26,0,26,0,3
65,DIV 7,0,3.637,22,0,22,0,3
66,DIV 5,250,3.68,8,0,8,0,3
67,DIV 5,100,2.173,6,0,6,0,3
68,DIV 1,150,3.358,30,30,0,0,3
69,DIV 2,50,3.69,30,26,4,4,3
70,DIV 5,200,3.41,26,8,18,8,3
71,DIV 2,0,2.877,21,21,0,0,3
72,DIV 3,250,3.141,15,15,0,0,3
73,DIV 5,100,2.059,9,0,9,0,3
74,DIV 5,150,2.264,6,0,6,0,3
75,DIV 2,50,2.929,21,21,0,0,3
76,DIV 3,200,3.016,13,13,0,0,3
77,DIV 6,0,2.649,19,0,19,0,3
78,DIV 2,250,3.739,24,24,0,0,3
79,DIV 6,100,3.864,18,0,18,0,3
80,DIV 1,150,4.725,40,40,0,0,3
81,DIV 3,50,2.722,13,13,0,0,3
82,DIV 2,200,3.722,26,26,0,0,3
83,DIV 7,0,3.484,37,0,37,0,3
84,DIV 6,250,3.908,16,0,16,0,3
85,DIV 7,100,3.002,23,0,23,0,3
86,DIV 5,150,4.334,17,4,13,4,3
87,DIV 6,50,3.096,19,0,19,0,3
88,DIV 1,200,3.684,29,29,0,0,3
89,DIV 1,0,3.519,28,28,0,0,3
90,DIV 5,250,2.372,8,0,8,0,3
91,DIV 6,100,2.638,19,0,19,0,3
92,DIV 6,150,2.779,18,0,18,0,3
93,DIV 7,50,3.186,25,0,25,0,3
94,DIV 1,200,4.247,29,29,0,0,3
95,DIV 1,0,3.368,29,29,0,0,3
96,DIV 1,250,4.609,28,28,0,0,3
97,DIV 2,100,3.076,22,22,0,0,3
98,DIV 6,150,3.198,18,0,18,0,3
99,DIV 3,50,3.765,13,13,0,0,3
100,DIV 2,200,4.355,23,23,0,0,3
101,DIV 2,0,3.978,30,30,0,0,3
102,DIV 7,250,3.697,29,0,29,0,3
103,DIV 6,100,3.484,22,0,22,0,3
104,DIV 2,150,5.452,31,27,4,4,3
105,DIV 7,50,3.197,24,0,24,0,3
106,DIV 2,200,3.894,22,22,0,0,3
107,DIV 2,0,4.157,22,22,0,0,3
108,DIV 1,250,4.147,31,31,0,0,3
1,DIV 7,200,3.551,35,0,35,0,5
2,DIV 7,250,3.396,34,0,34,0,5
3,DIV 3,150,4.258,41,28,13,13,5
4,DIV 3,0,3.791,23,19,4,4,5
5,DIV 5,100,3.236,32,11,21,11,5
6,DIV 5,50,2.872,24,4,20,4,5
7,DIV 6,200,3.217,24,0,24,0,5
8,DIV 5,250,5.537,30,9,21,9,5
9,DIV 1,150,6.056,45,45,0,0,5
10,DIV 7,0,3.974,44,0,44,0,5
11,DIV 5,100,3.44,31,10,21,10,5
12,DIV 2,50,2.859,31,31,0,0,5
13,DIV 3,200,2.947,18,18,0,0,5
14,DIV 6,250,2.915,26,0,26,0,5
15,DIV 2,150,4.18,45,36,9,9,5
16,DIV 3,0,2.486,18,18,0,0,5
17,DIV 1,100,2.593,21,21,0,0,5
18,DIV 2,50,4.09,42,37,5,5,5
19,DIV 6,200,3.292,22,0,22,0,5
20,DIV 3,250,5.364,29,21,8,8,5
21,DIV 7,150,3.725,23,0,23,0,5
22,DIV 1,0,2.779,18,18,0,0,5
23,DIV 3,100,3.541,17,17,0,0,5
24,DIV 2,50,3.279,30,24,6,6,5
25,DIV 7,200,2.535,26,0,26,0,5
26,DIV 2,250,7.32,2,2,0,0,5
27,DIV 6,150,3.878,36,7,29,7,5
28,DIV 1,0,3.515,40,40,0,0,5
29,DIV 6,100,6.17,33,5,28,5,5
30,DIV 1,50,3.795,30,30,0,0,5
31,DIV 5,200,3.226,30,13,17,13,5
32,DIV 7,250,2.667,26,0,26,0,5
33,DIV 5,150,2.554,13,0,13,0,5
34,DIV 2,0,3.011,30,26,4,4,5
35,DIV 2,100,3.319,26,26,0,0,5
36,DIV 7,50,2.788,36,0,36,0,5
37,DIV 6,200,2.962,29,2,27,2,5
38,DIV 1,250,2.843,17,17,0,0,5
39,DIV 5,150,4.578,24,7,17,7,5
40,DIV 6,0,2.617,26,0,26,0,5
41,DIV 5,100,3.146,29,6,23,6,5
42,DIV 6,50,3.101,29,0,29,0,5
43,DIV 2,200,3.101,37,37,0,0,5
44,DIV 1,250,4.304,26,26,0,0,5
45,DIV 5,150,4.191,54,20,34,20,5
46,DIV 2,0,3.336,33,33,0,0,5
47,DIV 3,100,2.681,17,17,0,0,5
48,DIV 7,50,3.6,39,0,39,0,5
49,DIV 3,200,3.594,45,26,19,19,5
50,DIV 7,250,2.629,24,0,24,0,5
51,DIV 2,150,3.142,37,37,0,0,5
52,DIV 6,0,4.34,40,6,34,6,5
53,DIV 7,100,4.419,39,0,39,0,5
54,DIV 6,50,3.315,31,6,25,6,5
55,DIV 5,200,2.395,15,0,15,0,5
56,DIV 3,250,2.464,17,17,0,0,5
57,DIV 1,150,3.204,22,22,0,0,5
58,DIV 7,0,2.998,36,0,36,0,5
59,DIV 3,100,2.836,13,13,0,0,5
60,DIV 5,50,2.694,20,4,16,4,5
61,DIV 1,200,4.946,22,22,0,0,5
62,DIV 1,250,4.556,27,27,0,0,5
63,DIV 2,150,3.201,33,33,0,0,5
64,DIV 1,0,3.613,34,34,0,0,5
65,DIV 7,100,2.746,28,0,28,0,5
66,DIV 1,50,3.412,37,37,0,0,5
67,DIV 5,200,4.124,27,6,21,6,5
68,DIV 5,250,5.208,21,4,17,4,5
69,DIV 6,150,3.891,33,0,33,0,5
70,DIV 6,0,5.669,45,7,38,7,5
71,DIV 1,100,4.332,31,31,0,0,5
72,DIV 6,50,4.549,37,3,34,3,5
73,DIV 2,200,4.944,36,31,5,5,5
74,DIV 6,250,4.174,40,10,30,10,5
75,DIV 1,150,3.978,37,37,0,0,5
76,DIV 5,0,4.231,30,12,18,12,5
77,DIV 7,100,2.809,32,0,32,0,5
78,DIV 1,50,2.529,23,23,0,0,5
79,DIV 7,200,3.146,34,0,34,0,5
80,DIV 2,250,4.005,33,33,0,0,5
81,DIV 3,150,3.119,20,20,0,0,5
82,DIV 7,0,3.859,33,0,33,0,5
83,DIV 6,100,4.151,28,0,28,0,5
84,DIV 7,50,2.694,22,0,22,0,5
85,DIV 3,200,4.075,23,11,12,12,5
86,DIV 2,250,4.365,27,27,0,0,5
87,DIV 7,150,2.62,25,0,25,0,5
88,DIV 2,0,2.646,25,25,0,0,5
89,DIV 6,100,3.056,28,6,22,6,5
90,DIV 3,50,1.732,15,15,0,0,5
91,DIV 2,200,2.459,26,26,0,0,5
92,DIV 6,250,4.479,32,0,32,0,5
93,DIV 3,150,2.801,22,22,0,0,5
94,DIV 3,0,4.552,43,29,14,14,5
95,DIV 1,100,2.571,30,30,0,0,5
96,DIV 5,50,2.803,25,7,18,7,5
97,DIV 1,200,4.222,66,47,19,19,5
98,DIV 3,250,5.477,38,30,8,8,5
99,DIV 7,150,3.108,25,0,25,0,5
100,DIV 5,0,3.363,17,0,17,0,5
101,DIV 2,100,4.176,37,34,3,3,5
102,DIV 3,50,2.773,24,16,8,8,5
103,DIV 1,200,3.581,24,22,2,2,5
104,DIV 5,250,3.719,25,5,20,5,5
105,DIV 6,150,3.536,35,5,30,5,5
106,DIV 5,0,2.617,17,4,13,4,5
107,DIV 2,100,2.787,34,34,0,0,5
108,DIV 3,50,2.158,15,15,0,0,5
1,DIV 5,250,4.648,22,8,14,8,6
2,DIV 5,0,1.887,11,0,11,0,6
3,DIV 7,200,2.854,22,0,22,0,6
4,DIV 7,50,3.39,25,0,25,0,6
5,DIV 5,150,5.044,19,6,13,6,6
6,DIV 2,100,3.115,20,20,0,0,6
7,DIV 1,250,2.993,22,22,0,0,6
8,DIV 6,0,3.982,17,0,17,0,6
9,DIV 5,200,3.557,21,6,15,6,6
10,DIV 5,50,3.538,40,17,23,17,6
11,DIV 6,150,3.46,26,3,23,3,6
12,DIV 1,100,3.312,41,41,0,0,6
13,DIV 5,250,3.96,41,15,26,15,6
14,DIV 1,0,3.005,31,31,0,0,6
15,DIV 5,200,4.931,47,16,31,16,6
16,DIV 2,50,3.439,18,18,0,0,6
17,DIV 7,150,4.189,29,0,29,0,6
18,DIV 2,100,5.088,26,23,3,3,6
19,DIV 1,250,3.011,29,29,0,0,6
20,DIV 1,0,2.786,21,21,0,0,6
21,DIV 2,200,4.131,40,35,5,5,6
22,DIV 3,50,3.062,27,22,5,5,6
23,DIV 3,150,3.354,31,23,8,8,6
24,DIV 7,100,3.349,22,0,22,0,6
25,DIV 7,250,3.436,20,0,20,0,6
26,DIV 7,0,2.993,18,0,18,0,6
27,DIV 7,200,3.607,19,0,19,0,6
28,DIV 1,50,3.472,17,17,0,0,6
29,DIV 6,150,3.851,24,7,17,7,6
30,DIV 7,100,3.676,24,0,24,0,6
31,DIV 6,250,5.123,32,10,22,10,6
32,DIV 1,0,4.033,14,14,0,0,6
33,DIV 7,200,4.981,21,0,21,0,6
34,DIV 1,50,3.197,22,22,0,0,6
35,DIV 5,150,5.217,39,19,20,19,6
36,DIV 1,100,2.982,20,20,0,0,6
37,DIV 3,250,4.361,11,11,0,0,6
38,DIV 3,0,1.996,10,10,0,0,6
39,DIV 1,200,2.741,21,21,0,0,6
40,DIV 2,50,3.133,18,18,0,0,6
41,DIV 3,150,6.457,37,21,16,16,6
42,DIV 5,100,3.639,22,10,12,10,6
43,DIV 2,250,2.962,14,14,0,0,6
44,DIV 6,0,2.8,13,0,13,0,6
45,DIV 1,200,2.927,18,18,0,0,6
46,DIV 5,50,4.071,19,6,13,6,6
47,DIV 7,150,3.681,30,0,30,0,6
48,DIV 2,100,2.941,17,17,0,0,6
49,DIV 2,250,6.079,45,33,12,12,6
50,DIV 7,0,2.617,18,0,18,0,6
51,DIV 2,200,3.07,12,12,0,0,6
52,DIV 1,50,2.831,25,25,0,0,6
53,DIV 3,150,3.402,17,11,6,6,6
54,DIV 6,100,4.17,35,11,24,11,6
55,DIV 7,250,2.983,25,0,25,0,6
56,DIV 6,0,4.108,27,5,22,5,6
57,DIV 2,200,3.743,32,26,6,6,6
58,DIV 5,50,3.071,21,11,10,11,6
59,DIV 1,150,3.271,26,26,0,0,6
60,DIV 1,100,2.956,31,31,0,0,6
61,DIV 7,250,4.12,28,0,28,0,6
62,DIV 7,0,3.214,29,0,29,0,6
63,DIV 6,200,5.218,32,4,28,4,6
64,DIV 6,50,2.735,22,0,22,0,6
65,DIV 1,150,3.479,44,44,0,0,6
66,DIV 5,100,4.135,35,15,20,15,6
67,DIV 1,250,3.871,26,26,0,0,6
68,DIV 5,0,2.993,15,6,9,6,6
69,DIV 1,200,3.193,30,30,0,0,6
70,DIV 3,50,3.844,32,21,11,11,6
71,DIV 7,150,4.118,25,0,25,0,6
72,DIV 3,100,6.948,57,27,30,30,6
73,DIV 6,250,4.274,16,0,16,0,6
74,DIV 3,0,3.506,15,10,5,5,6
75,DIV 3,200,5.038,27,23,4,4,6
76,DIV 7,50,3.262,21,0,21,0,6
77,DIV 5,150,3.57,20,8,12,8,6
78,DIV 6,100,3.57,21,0,21,0,6
79,DIV 2,250,3.144,19,18,1,1,6
80,DIV 2,0,3.304,18,18,0,0,6
81,DIV 5,200,3.511,13,7,6,7,6
82,DIV 2,50,2.896,16,16,0,0,6
83,DIV 6,150,5.442,25,7,18,7,6
84,DIV 3,100,6.544,61,37,24,24,6
85,DIV 6,250,4.598,19,4,15,4,6
86,DIV 5,0,4.773,29,14,15,14,6
87,DIV 6,200,3.365,18,0,18,0,6
88,DIV 6,50,3.282,16,0,16,0,6
89,DIV 2,150,3.941,19,19,0,0,6
90,DIV 7,100,2.927,16,0,16,0,6
91,DIV 3,250,3.257,9,9,0,0,6
92,DIV 2,0,2.664,18,18,0,0,6
93,DIV 6,200,3.649,32,8,24,8,6
94,DIV 3,50,2.207,11,11,0,0,6
95,DIV 2,150,6.264,29,24,5,5,6
96,DIV 3,100,3.216,10,10,0,0,6
97,DIV 3,250,3.73,9,9,0,0,6
98,DIV 3,0,2.768,9,9,0,0,6
99,DIV 3,200,2.538,8,8,0,0,6
100,DIV 6,50,3.296,19,5,14,5,6
101,DIV 1,150,3.439,18,18,0,0,6
102,DIV 5,100,8.767,32,14,18,14,6
103,DIV 5,250,3.404,14,6,8,6,6
104,DIV 2,0,3.241,15,15,0,0,6
105,DIV 3,200,3.419,14,14,0,0,6
106,DIV 7,50,3.928,20,0,20,0,6
107,DIV 2,150,2.975,20,20,0,0,6
108,DIV 6,100,6.209,23,5,18,5,6
